%%%%%%%
% P   %
% %%  %
% %.  %
% %%  %
%. G  %
%%%%%%%
