%%%%%%%
% P   %
%.% . %
% %   %
%.% . %
%  G  %
%%%%%%%