%%%%%%%
% P   %
%.%%. %
% %   %
%.%%. %
%  G  %
%%%%%%%